*************
*+...***...+*
*.**.***.**.*
*.*.......*.*
*...*****...*
***...*...***
*...*...*...*
*.***.*.***.*
*+....*....+*
*************
