****************
*+....****....+*
*.***.****.***.*
*.*..........*.*
*...**.**.**...*
*.***......***.*
*.....****.....*
*.**.******.**.*
*....******....*
****...**...****
*....*....*....*
*.****.**.****.*
*+.....**.....+*
****************
