*************
*+....*....+*
*.**.***.**.*
*.*.......*.*
*...*****...*
***...*...***
*...*...*...*
*.***.*.***.*
*+....*....+*
*************